11111111111111111111111111111111111111111111111111
10000000000000000000000000000000000000000000000001
10000000000000000000000000000000000000000000000001
10000000000000000000000000000000000000000000000001
10000000000000000000000000000000000000000000000001
10000000000000000000000000000000000000000000000001
10000000000000000000000000000000000000000000000001
10000000000000000000000000000000000000000000000001
10000000000000000000000000000000000000000000000001
10000000000000000000000000000000000000000000000001
10000000000000000000000000000000000000000000000001
10000000000000000000000000000000000000000000000001
10000000000000000000000000000000000000000000000001
11111111111111100000000000000000000000000000000001
10000000000000100000000000000000000000000000000001
10000000000000100000000000000000000000000000000001
10000000000000100000000000000000000000000000000001
10000000000000100000000000000000000000000000000001
10000000000000100000000000000000000000000000000001
10000000000000100000000000000000000000000000000001
10000111000011100000000000000000000000000000000001
10000001000000100000000000000000000000000000000001
10000001000000100000000000000000000000000000000001
10000001000000100000000000000000000000000000000001
10000111000000100000000000000000000000000000000001
10000001110000100000000000000000000000000000000001
10000001000000100000000000000000000000000000000001
10000001000000100000000000000000000000000000000001
10000001000000100000000000000000000000000000000001
10000001000000100000000000001111111111111111111111
10000001000000100000000000000000000000000000000001
10000001000011100000000000000000000000000000000001
10000000000000000000000000000000000000000000000001
11100000000000000000000000000000000000000000000001
10000000000000000000000000001111111111111000000001
10000000000000100000000000001000000000000100000001
10000000000001110000000000001000000000000010000001
10000000000011111000000000001000000000000001000001
10000000000111111100000000001111000000000000100001
11111100011111111111000111111000000000000000010001
10000000000000100000000000001000000000000000000001
10000000000000100000000000001000000000000000000001
10000000000000000000000000000000000000000000000001
10000000000000000000000000000000000000000000000001
10000000000000000000000000000000000000000000000001
45555555555555555555555555555555555555555555555554
46666666666666666666666666666666666666666666666664
46666666666666666666666666666666666666666666666664
46666666666666666666666666666666666666666666666664
46666666666666666666666666666666666666666666666664
