000000000000000
000000000111000
000000011111100
000000001100000
000000000000000
000000000000000
001000000000000
011110000000000
000110000111110
000000001111111
000000011111111
000000111111111
000001111111111
000111111111111
111111111111111
