11111111111111111111111111111111111111111111111111
10000000000000000000000000000000000000000000000001
10000000000000000000000000000000000000000000000001
10000000000000000000000000000000000000000000000001
10000000000000000000000000000000000000000000000001
10000000000000000000000000000000000000000000000001
10000000000000000000000000000000000000000000000001
10000000000000000000000000000000000000000000000001
10000000000000000000000000000000000000000000000001
10000000000000000000000000000000000000000000000001
10000000000000000000000000000000000000000000000001
10000000000000000000000000000000000000000000000001
10000000000000000000000000000000000000000000000001
10000000000000000000000000000000000000000000000001
10000000000000000000000000000000000000000000000001
10000000000000000000000000000000000000000000000001
10000000000000000000000000000000000000000000000001
10000000000000000000000000000000000000000000000001
10000000000000000000000000000000000000000000000001
10000000000000000000000000000000000000000000000001
10000000000000000000000000000000000000000000000001
10000000000000000011111111111111000000000000000001
10000000000000000011111111111111000000000000000001
10000000000000000011111111111111000000000000000001
10000000000000000000000000000000000000000000000001
10000000000000000000000000000000000000000000000001
10000000000000000000000000000000000000000000000001
10000000000000000000000000000000000000000000000001
11111111110000000000000000000000000000000000000001
11111111110000000000000000000000000000000000000001
11111111110000000000000000000000000000000000000001
10000000000000000000000000000000000000000000000001
10000000000000000000000000000000000000000000000001
10000000000000000000000000000000000000000000000001
10000000000000000000000000000000000000000000000001
10000000000000000000000000000000000000000000000001
10000000000000000000000000000000000000000000000001
10000000000000000000000000000000000000000000011111
10000000000000000000000000000000000000000000011111
10000000000000000110000000000000000000000000011111
10000000000000000110000000000000000000000000000001
10000000000000011110000000000000000000000000000001
10000000000000011110000000000000000000000000000001
10000000000001111110000000000000000000000000000001
10000000000001111110000000000000000000000000000001
10000000000111111110000000000000000000000000000001
10000000000111111110000000000000000000000000000001
11111111111111111111111111111110000000001111111111
11111111111111111111111111111110000000001111111111
11111111111111111111111111111110000000001111111111
